+S-----+
|      |
|--- - |
F  --  |
|- | | |
|    - |
|  -   |
+------+