+S-----+
| |    |
|   |--+
| |  | F
| | |  |
| |-- +|
|      |
+------+