+S-----+
| |    |
| |  | |
| |- | |
| |  | |
|   -- |
|  |   |
+---F--+